"tileset":"D:\repositories\gameeditor\img\spritesheet.png",
"tileset-width":"96",
"tileset-height":"128",
"tile-size":"32",
"map-data": [
	"0","0","0","0","0","0","0","0","0","0","0","0","0","0","0","0","0","0","0","0","0","0","0","0","0","0","0","0","0","0","0","0",
	"0","0","0","0","0","0","0","0","0","0","0","0","0","0","0","0","0","0","0","0","0","0","0","0","0","0","0","0","0","0","0","0",
	"0","0","0","0","0","0","0","0","0","0","0","0","0","0","0","0","0","0","0","0","0","0","0","0","0","0","0","0","0","0","0","0",
	"0","0","0","0","0","0","0","0","0","0","1","1","1","1","0","0","0","0","0","1","1","1","1","0","0","0","0","0","0","0","0","0",
	"0","0","0","0","0","0","0","0","0","0","1","1","1","1","0","0","0","0","0","1","1","1","1","0","0","0","0","0","0","0","0","0",
	"0","0","0","0","0","0","0","0","0","0","1","1","1","1","0","0","0","0","1","1","1","1","1","0","0","0","0","0","0","0","0","0",
	"0","0","0","0","0","0","0","0","0","0","0","0","0","0","0","0","0","0","0","0","0","0","0","0","0","0","0","0","0","0","0","0",
	"0","0","0","0","0","0","0","0","0","0","0","0","0","0","0","0","0","0","0","0","0","0","0","0","0","0","0","0","0","0","0","0",
	"0","0","0","0","0","0","0","0","0","0","2","0","0","0","0","0","0","0","0","0","0","0","2","0","0","0","0","0","0","0","0","0",
	"0","0","0","0","0","0","0","0","0","0","2","2","0","0","0","0","0","0","0","0","0","2","2","0","0","0","0","0","0","0","0","0",
	"0","0","0","0","0","0","0","0","0","0","0","2","2","2","0","0","0","0","0","0","0","2","0","0","0","0","0","0","0","0","0","0",
	"0","0","0","0","0","0","0","0","0","0","0","0","0","2","2","2","0","0","2","2","2","2","0","0","0","0","0","0","0","0","0","0",
	"0","0","0","0","0","0","0","0","0","0","0","0","0","0","0","2","2","2","2","0","0","0","0","0","0","0","0","0","0","0","0","0",
	"0","0","0","0","0","0","0","0","0","0","0","0","0","0","0","0","0","0","0","0","0","0","0","0","0","0","0","0","0","0","0","0",
	"0","0","0","0","0","0","0","0","0","0","0","0","0","0","0","0","0","0","0","0","0","0","0","0","0","0","0","0","0","0","0","0",
	"0","0","0","0","0","0","0","0","0","0","0","0","0","0","0","0","0","0","0","0","0","0","0","0","0","0","0","0","0","0","0","0",
	"0","0","0","0","0","0","0","0","0","0","0","0","0","0","0","0","0","0","0","0","0","0","0","0","0","0","0","0","0","0","0","0",
	"0","0","0","0","0","0","0","0","0","0","0","0","0","0","0","0","0","0","0","0","0","0","0","0","0","0","0","0","0","0","0","0"
],
"object-data": [
	"Foo": {
		"x":"323",
		"y":"202",
		"width":"150",
		"height":"30",
		"sprite":"D:\repositories\gameeditor\img\spritesheet.png",
		"properties": (
			"foo":"bar",
		)
	}
]