"tileset":"D:\repositories\gameeditor\img\spritesheet.png",
"tileset-width":"96",
"tileset-height":"128",
"tile-size":"32",
"map-data": [
	"0","0","0","0","0","0","0","0","0","0","0","0","0","0","0","0","0","0","0","0","0","0","0","0","0","0","0","0","0","0","0","0",
	"0","0","0","0","0","0","0","0","0","0","0","0","0","0","0","0","0","0","0","0","0","0","0","0","0","0","0","0","0","4","4","0",
	"0","0","0","0","0","0","0","0","0","0","0","4","4","0","0","4","4","4","4","4","0","0","0","4","4","4","4","4","4","4","0","0",
	"0","0","0","0","0","0","4","4","4","4","4","4","4","4","4","4","4","4","4","4","4","4","4","4","4","4","4","0","0","0","0","0",
	"0","0","0","0","0","0","4","4","0","0","4","4","4","4","4","4","4","4","4","4","0","0","4","4","4","0","0","0","0","0","0","0",
	"0","0","0","0","0","0","4","4","5","5","5","5","5","5","5","4","0","0","0","4","4","4","4","0","0","0","0","0","0","0","0","0",
	"0","0","0","0","0","0","0","0","5","5","5","0","0","0","0","5","5","4","5","5","5","5","0","0","0","0","0","0","0","0","0","0",
	"0","0","0","0","0","0","0","0","0","0","0","0","0","0","0","0","5","5","5","0","0","5","5","0","0","0","0","0","0","0","0","0",
	"0","0","0","0","0","0","0","0","0","0","0","0","0","0","0","5","5","0","0","0","0","5","0","0","0","0","0","0","0","0","0","0",
	"0","0","0","0","0","0","0","0","0","0","0","0","0","0","0","5","5","0","0","0","0","5","0","0","0","0","0","0","0","0","0","0",
	"0","0","0","0","0","0","0","0","0","0","0","0","0","0","0","0","0","0","0","0","0","5","0","0","0","0","0","0","0","0","0","0",
	"0","0","0","0","0","0","0","0","0","0","0","0","0","0","0","0","0","0","0","0","0","0","0","0","0","0","0","0","0","0","0","0",
	"0","0","0","0","0","0","0","0","0","0","0","0","0","0","0","0","0","0","0","0","0","0","0","0","0","0","0","0","0","0","0","0",
	"0","0","0","0","0","0","0","0","0","0","0","0","0","0","0","0","0","0","0","0","0","0","0","0","0","0","0","0","0","0","0","0",
	"5","5","5","5","5","5","5","5","5","5","5","0","0","0","0","0","0","0","0","0","0","0","0","0","0","0","0","0","0","0","0","0",
	"0","0","0","0","0","0","0","0","0","0","5","5","5","0","0","0","0","0","0","0","0","0","0","0","0","0","0","0","0","0","0","0",
	"0","0","0","0","0","0","0","0","0","0","0","0","5","5","0","0","0","0","0","0","0","0","0","0","0","0","0","0","0","0","0","0",
	"0","0","0","0","0","0","0","0","0","0","0","0","5","0","0","0","0","0","0","0","0","0","0","0","0","0","0","0","0","0","0","0"
],
"object-data": [
	"foo": {
		"x":"145",
		"y":"122",
		"width":"200",
		"height":"50",
		"sprite":"D:\repositories\gameeditor\img\spritesheet.png",
		"properties": (
			"foo":"bar",
		)
	}
]